NO textures/wolfenstein/blue_stone.xpm
SO ./textures/wolfenstein/color_stone.xpm
WE ./textures/wolfenstein/eagle.xpm
EA ./textures/wolfenstein/grey_stone.xpm

F 205,105,180
C 173,216,230

111111111111111111111111111111111111
100000000000000000000000000000000001
101111111111111111110000000000000001
100000000000000000010000111111111001
111111111111111100010000100000000001
10000000E000000100011111100000111111
100011111111110100000000100000100001
100010000000010111111000111111100001
100011101100000000000000000000000001
111111100111111111111111111100000001
100000100000000000000000000100000001
100000100011111111100111100111111101
100000100010000001000100100000000001
100000111110001111111100100000001001
100000000000000000000000111111111111
111111111111111111111111111111111111
