NO ./textures/wolfenstein/blue_stone.xpm
SO ./textures/wolfenstein/color_stone.xpm
WE ./textures/wolfenstein/eagle.xpm
EA ./textures/wolfenstein/grey_stone.xpm

F 220,100,0
C 225,30,0

111111111111111111111111
100000001000000010000001
100000001000000010000001
100000001000000010000001
100000111110000111010001
100111100010000000000001
100000100010000100010001
100000100010000000000001
100000110110000111111111
100000000000000010000001
100000000000000010000001
100000000000000010000001
100000000000000110000001
100000000000000110000001
10000000000000001000N001
100000000000000010000001
111111111000000010000001
110100001000000000000001
110000101000000000000001
110100001000000000000001
110111111000000000000001
110000000000000000000001
111111111000000000000001
111111111111111111111111
